5
00000000000000000
00000000000000000
00000000000000000
00000001111100100
00000001000000000
00001111111110000
00000100000010000
01111111111111110
00000000000000000
00000000000000000
00000000000000000
00000000000000000
00000000000000000
00000000000000000
00000000000000000
00000000000000000
00000000000000000
00000000000000000
00000000000000000
