5
00000000000000000
00000000000000000
00000000000000000
00111111111111100
00000000100000000
00000000100000000
00000000100000000
00000001000000000
00000001000000000
00001111111110000
00000000000000000
00000000000000000
00000000000000000
00000000000000000
01111111111111110
00000000000000000
00000000000000000
00000000000000000
00000000000000000
