3
00000001000000000
00000001000000000
00000001000000000
00111111111111100
00000001000000000
00000001000000000
00000001000000000
00000001000000000
00000001000000000
00001111111110000
00000001000000000
00000001000000000
00000001000000000
00000001000000000
01111111111111110
00000001000000000
00000001000000000
00000001000000000
00000001000000000
