3
00000000000000000
00000000000000000
00000000000000000
00111111111111100
00000000000000000
00000000000000000
00000000000000000
00000000000000000
00000000000000000
11111111111111111
00000000000000000
00000000000000000
00000000000000000
00000000000000000
01111111111111110
00000000000000000
00000000000000000
00000000000000000
00000000000000000
