2
00000000000000000
00000000000000000
00000000000000000
00000000000000000
11111111111111111
00000000000000011
00000000000000100
00000000000000000
00000000000000000
00000000000000000
00000000000000000
00000000000000000
11111111111111111
00000000000000011
00000000000000100
00000000000000000
00000000000000000
00000000000000000
00000000000000000
