5
00111111111111100
00000000100000000
00000000100000000
00000000100000000
00000000100000000
00000000100000000
00000001000000000
00000001000000000
00001111111110000
00001111111110000
00000010000010000
00000010000010000
00000010000010000
00000010000010000
00000100000010000
00000100000010000
00001000000010000
01111111111111110
00000000000000000
