3
00000000000000000
00000000000000000
00000000000000000
00000011111000000
00000000000000000
00000000000000000
00000000000000000
00000000000000000
00000000000000000
00001111111110000
00000000000000000
00000000000000000
00000000000000000
00000000000000000
01111111111111110
00000000000000000
00000000000000000
00000000000000000
00000000000000000
