5
00111111111111100
00000001000000000
00011111111111000
00001000000010000
01111111111111110
00000000000000000
00000000000000000
00000000000000000
00000000000000000
00000000000000000
00000000000000000
00111111111111100
00000001000000000
00011111111111000
00001000000010000
01111111111111110
00000000000000000
00000000000000000
00000000000000000
